################
#..............#
#..............#
#..............#
#..............#
#..............#
#.....%.....%..#
#..%......%....#
#......%.......#
#....%......%..#
#.@.......%....#
################