################
#..............#
#..............#
#..............#
#..............#
#..............#
#......%.......#
#...@.....%....#
#..............#
#.....%........#
#..............#
################