################
#..............#
#..............#
#..............#
#..............#
#..............#
#......%....%..#
#.@...%...%....#
#............&.#
#...%......%...#
#..............#
################