################
#..............#
#..............#
#..............#
#..............#
#..............#
#......%....%..#
#.@...%...%....#
#..............#
#...%......%...#
#..............#
################